777777777777777777777777777777777777777777777777777777777777777777777777777777777777777777777777777777777777777777777777777777777777777777777777777777777777777777777777
777111111111111111111111111111111111111111111111111111111111111111111111111111111111111111111111111111111111111111111111111111111111111111111111111111111111111111111777
771111111111111111111111111111111111111111111111111111111111111111111111111111111111111111111111111111111111111111111111111111111111111111111111111111111111111111111177
711111111111111111111111111111111111111111111111111111333311111111111111111111111111111111111111111111111111111111111111111111111111111111111111111111111111111111111117
711111111111111111111111111111111111111131111111111113311311133111111111111111111111111111111111111111111111111111111111111111111111111111111111111111111111111111111117
711111111113111111111111111111111111111131111111111113111311333111111111111111111111111111111111111111111111111111111111111111111111111111111111111111111111111111111117
711111111113111111111111111111111111111113111113311133111311313331111111111111111111111111111111111111111111111111111111111111111111111111111111111111111111111111111117
711111111113111111111111111113111111311113311331111131111313111111111111111111111111111111111111111111111111111111111111111111111111111111111111111111111111111111111117
711111111113111111111111111113311113311111333111111131111311311111111111111111111111111111111111131111311111111111111111111111111111111111111111111111111111111111111117
711111111113111111111111111111131131111111333111111131111311311111111111111111111111111111111111131111311111111111111111111111111111111111111111111111111111111111111117
711111111113133311111111111111113311111111313311111131113311311111111111111111111111111111111111131111311111111111111111111111111111111111111111111111111111111111111117
711111111113131311111333311111113331111133111331111133113111311111111111111111111111111111111111131111311111111111311113111111111111111111111111111111111111111111111117
711111111113311131113311311111133133111131111131111113331111111111111111111111111111111111111111131111311111111111111113111111111111111111111111111111111111111111111117
711111111113311131131111311111131113111111111111111111111111111111111111111111111111111111111111133333311333331111111113111111111111111111111113331111111111111111111117
711111111113111131133333311111331113311111111111333331111111111111111111113333333333311111111111131111311311331111311113111111111111111111111131111111111111111111111117
711111111113111131111111331111311111111111111133111111111111111111111111111111111111333111111111131111311311311111311113111111111111111111113311111111111111111111111117
711111111111111131111111133111111111111111333311111111111111111111111111111111111111111331111111131111111331331111311113111111111111111111131111111111111111111111111117
711111111111111111111111111111111111111133111111111111111111111111111111111111111111111113311111111111111133333111311113111111111111111111311111111111111111111111111117
711111111111111111111111111111111111133311111111111111111111111111111111111111177111111111331111111111111111113111311113333333311111111113111111111111111111111111111117
711111111111111111111111111111111113311111111771111111111111111111111111111111177711111111111111111111111111111111111111111111111111111131111111111111111111111111111117
711111111111111111111111111111111111111111111717111111111111111111111111111111171771111111111111111111111111111111111111111111111111111131111111111111111111111111111117
711111111111111111111111111111111111111111111717711111111111111111111111111111171171111111111111111111111111111111111111111111111111111311111111111111111111111111111117
711111111111111111111111111111111111111111111711711111111111111111111111111111171171111111111111111111111111111111111111111111111111113111111111111111111111111111111117
711111111111111111111111111111111111111111111711771111111111111111111111111111171177111111111111111111111111111111111111111111111111113111111111111111111111111111111117
711111111111111111111111111111111111111111111711171111111111111111111111111111171117111111111111111111111111111111111111111111111111131111111111111111111111111111111117
711111111111111111111111111111111111111111111711171111111111111111111111111111171117111111111111111111111111111111111111111111111111311111111111111111111111111111111117
711111111111111111111111111111111111111111111711117111111111111111111111111111171317111111111111111111111111111111111111111111111113111111111111111111111111111111111117
711111111111111111111111111111111111111111111713117111111111111111111111111111171117111111111111111111111111111111111111111111111113111111113333333111111111111111111117
711111111111111111111111111111111111111111111711117111111111111111111111111111171171111111111111111111111111111111111111111111111131111111331111111331111111111111111117
711111111111111111111111111117711111111111111711117111111111111111111111111111171171111111111111111111111111111111111111111111111131111111311111111131111111111111111117
711111111111111111111111111177111111111111111711171111111111111111111111111111171171111111111111111111111111111111111111111111111131111113311111111131111111111111111117
711111111111111111111111117777111111111111111711771111111111111111111111111111717711111111111111111111111111111111111111111111111131111113111111111131111111111111111117
711111111111111111111111177777111111111111111717711111111111111111111111111111777111111111111111111771111111111111111111111111111131111133111111111311111111111111111117
711111111111111111111111177777111111111111111777111111111111111111111111111111711111111111111111111771111111111111111111111111111311111131111111111311111111111111111117
711111111111111111111117777777111111111111117771111111111111111111111111111117711111111111111111111777111111111111111111111111111311111311111111111311111111111111111117
711111111111111111111117777777111111111111111111111111111111111111111111111771111111111111111111111777111111111111111111111111111311111311111111111311111111111111111117
711111111111111111111117777777111111111111111111111111111111111177111111111111111111111111111111111777711111111111111111111111111311113111111111113111111111111111111117
711111111111111111111177777777111111111111111111111111111111117777111111111111111111111111111111111777711111111111111111111111111311113111111111113111111111111111111117
711111111111111111111177777777111111111111111111111111111111177111111111111111111111111111111111111777711111111111111111111111111311113111111111131111111111111111111117
711111111111111111111777777777111111111111111111111111111111171111111111111111111111111111111111111777771111111111111111111111111311133111111111311111111111111111111117
711111111111111111111777777777111111111111111111111111111111171111111111111111111111111111111111111777771111111111111111111111111311131111111113111111111111111111111117
711111111111111111111777777777111111111111111111111111111111171111111111111111111111111111111111111777771111111111111111111111111311131111111131111111111111111111111117
711111111111111111111777777777111111111111111111111111111111171111111111111111111111111111111111111777777111111111111111111111111311131111113311111111111111111111111117
711111111111111111111777777777111111111111111111111111111111171111111111111111111111111111111111111777777111111111111111111111111131131111131111111111111111111111111117
711111111111111111111777777777111111111111111111111111111111711111111111111111111111111111111111111777777111111111111111111111111113333333311111111111111111111111111117
711111111111111111111777777777111111111111111111111111111111711111111111111111111111111111111111117777777111111111111111111111111111111111111111111111111111111111111117
711111111111111111111777777777711111111111111111111111111111711111111111111111111111111111111111117777777111111111111111111111111111111111111111111111111111111311111117
711111111111111111111777777777711111111111111111111111111111711171111111111111111111111111111111117777777111111111111111111111111111111111111311111111111111111311111117
711111111111111111111777777777771111111111111111111111111111711171111111111111111111111111111111117777777111111111111111111111111111111111133311111111111111113111111117
711111111111111111111777777777771111111111111111111111111111777777711111111111111111111111111111177777777111111111111111111111111111111111131111111111111111113111111117
711111111111111111111777777777771111111111111111111111111111111111111111111111111111111111111111177777777111111111111111111111111111111111311111111111111111131111111117
711111111111111111111777777777777111111111111111111111111111111111111111111111111111111111111111777777777111111111111111111111111111111113111111111111111111131111111117
711111111111111111111777777777777711111111111111111111111111111111111111111111111111111111111111777777777111111111111111111111111111111131111111111111111111131111111117
711111111111111111111777777777777711111111111111111111111111111111111111111111111111111111111117777777777111111111111111111111111111113311111111111111111111311111111117
711111111111111111111777777777777777111111111111111111111111111111111111111111111111111111111117777777777111111111111111111111111111113111111111111111111111311111111117
711111111111111111111777777777777777711111111111111111111111111111111111111111111111111111111177777777777111111111111111111111111111131111111111111111111111311111111117
711111111111111111111777777777777777771111111111111111111111111111111111111111111111111111111777777777777111111111111111111111111111311111111111111111111113111111111117
711111111111111111111777777777777777777711111111111111111111111111111111111111111111111111117777777777777111111111111111111111111113111111111111111111111113111111111117
711111111111111111111777777777777777777777111111111111111111111111111111111111111111111111177777777777777111111111111111111111111131111111111111111111111131111111111117
711111111111111111111177777777777777777777771111111111111111111111111111111111111111111111777777777777777111111111111111111111111131111111111111111111111131111111111117
711111111111111111111117777777777777777777777711111111111111111111111111111111111111111177777777777777771111111111111111111111111311111111111111111111111311111111111117
711111111111111111111117777777777777777777777777771111111111111111111111111111111111777777777777777777771111111111111111111111111311111111111111111111111311111111111117
711111111111111111111111777777777777777777777777773333333337777777777773333333333337777777777777777777771111111111111111111111113111111111111111111111113111111111111117
711111111111111111111111777777777777777777777777733333333337777777777777333333333777777777777777777777771111111111111111111111113111111111111111111111113111111111111117
711111111111111111111111177777777777777777777777773333333337777777777777333333333777777777777777777777771111111111111111111111131111111111111111111111131111111111111117
711111111111111111111111117777777777777777777777773333333337777777777777333333333777777777777777777777711111111111111111111111131111111111111111111111131111111111111117
711111111111111111111111117777777777777777777777773333333337777777777777333333333777777777777777777777711111111111111111111111131111111111111111111111311111111111111117
711111111111111111111111111777777777777777777777773333333337777777777777333333333777777777777777777777711111111111111111111111131111111111111111111111311111111111111117
711111111111111111111111111177777777777777777777773333333377777777777777333333337777777777777777777777711111111111111111111111311111111111111111111111313333331111111117
711111111111111111111111111177777777777777777777777333333777777777777777333333337777777777777777777777711111111111111111111111311111133333311111111111331111113311111117
711111111111111111111111111117777777777777777777777333333777777777777777333333337777777777777777777777711111111111111111111111311111311111133111111113311111111131111117
711111111111111111111111111111777777777777777777777733377777777777777777733333377777777777777777777777711111111111111111111111311133111111113111111111311111111131111117
711111111111111111111111111111177777777777777777777777777777777777777777773333777777777777777777777777711111111111111111111111311331111111111311111111311111111131111117
711111111111111111111111111111117777777777777777777777777777777777777777777777777777777777777777777777711111111111111111111111311311111111111311111111311111111131111117
711111111111111111111111111111111177777777777777777777777777777777777777777777777777777777777777777777711111111111111111111111311311111111111311111111311111111131111117
711111111111111111111111111111111111777777777777777777777777777777777777777777777777777777777777777777711111111111111111111111331111111111113111111111311111111131111117
711111111111111111111111111111111111117777777777777777777777777777777777777777777777777777777777777777111111111111111111111111133111111111113111111111311111111311111117
711111111111111111111111111111111111111111777777777777777777777777777777777777777777777777777777777711111111111111111111111111111333111111333111111111311111113111111117
711111111111111111111111111111111111111111117777777777777777777777777777777777777777777777777777777111111111111111111111111111111111333333111111111111131111113111111117
711111111111111111111333311111111111111111111177777777777777777777777777777777777777777777777771111111111111111111111111111111111111111111111111111111113333331111111117
711111111111111111113111111111111111111111111111111111111777777777777777777777777777777111111111111111111111111111111111111111111111111111111111111111111111111111111117
711111111111111111331111111111111111111111111111111111111111111111111111111111111111111111111111111111111111111111111111111111111111111111111111111111111111111111111117
711111111111111113111111111111111111111111111111111111111111111111111111111111111111111111111111111111111111111111113111111111111111111111111111111111111111111111111117
711111111111111131111111111111111111113111111111111111111111111111111111111111111111113111111111111111111111111111113111111111111111111111111111111111111111111111111117
711111111111111131111111111111111111113111111111111111111111111111111111111111111111113111111111111111111111111111333333333111111111111111111111111111111111111111111117
711111111111111113111111111133111111113111111111111111111111113111111111111111111111113111333333111111333333111111113111111111111111111111111111111111111111111111111117
711111111111111111311111111311311111113111111111111111111111131311111111111111111111113111111113111111111113111111113111111111111111111111111111111111111111111111111117
711111111111111111331111113111311333333333333111111111111113311331111111111111111111113111111113111111111333333111113111111111111111111111111111111111111111111111111117
711111111111111111133111113111311111113111111133331111111113111131111111111111111111113111111133331111111331113111113111111111111111111111111111111111111111111111111117
711111111111111111113111113333311111113111111311113311111131111131111111111111111111113111111331113111111111113111113111111111111111111111111111111111111111111111111117
711111111111111111333111111111131111113111113311113311111331111131111111111111111111113111111311113311111111113111113111111111111111111111111111111111111111111111111117
711111111111111133311111111111131111113111113111133111111311111131111111111111111111113111111111111311111111133111113111111111111111111111111111111111111111111111111117
711111111111111111111111111111113311113111113333333111111311111111111111111111111111113111111111113311111333311111111111111111111111111111111111111111111111111111111117
771111111111111111111111111111111111111111111111111331111111111111111111111111111111113111111111131111133111111111111111111111111111111111111111111111111111111111111177
777111111111111111111111111111111111111111111111111111111111111111111111111111111111113111131113311111111111111111111111111111111111111111111111111111111111111111111777
777777777777777777777777777777777777777777777777777777777777777777777777777777777777773777733337777777777777777777777777777777777777777777777777777777777777777777777777

